1333333333333333331
1333333333333333331
1333333333333333331
1333333333333333331
1333333333333333331
1333333333333333331
1333333333333333331
1333333333333333331
1111111333333333331
1333333333331111111
1333333333333333331
1333333333331111111
1333333333333333331
1333333333333333331
1333333333333333331
1333333333333333331
1333333333311111111
1333333333333333331
1333333333333333331
1333333333333333331
1333333333333333331
1333333313333333331
1333333333333333331
1333333333333333331
1333333313333333331
1333333313333333331
1333333313333333331
1333333313313333331
1333333333333333331
1333333313333333331
1333333333333333331
1333313333333333331
1333333333333333331
1333333333333333331
1331333333333333331
1333333333333333331
1333333333333333331
1333333333333333331
1333333133333333331
1333333333333333331
1333333333333311111
1333333333333333331
1333333333333311111
1333333333333333331
1333333333333333331
1333333333333333331
1333333113333333331
1333333333333333331
1333333333333333331
1333333333333333331
1333333333333333331
1111111111111111111
1111111111111111111
1111111111111111111
1111111111111111111
1111111111111111111
1111111111111111111





           